Alexa|ia_archiver|
Ask.com/Teoma|AskJeeves/Teoma)|
Biz360|Biz360|
Naver|NaverBot|
Naver|Cowbot|
cURL|curl/|
Google|Googlebot/|
Google|googlebot/|
Google Images|Googlebot-Image|
LookSmart|grub-client|
Yahoo!|slurp@inktomi|
Yahoo!|Yahoo!Slurp|
Yahoo!|MMCrawler|
MSN|msnbot|
AltaVista|Scooter-|
Wget|Wget/1.|
Technorati|Technoratibot|
Moreover|Moreoverbot|
Yahoo FeedSeeker|YahooFeedSeeker|
Java|Java/|
relevantNOISE|www.relevantnoise.com|
Voila|VoilaBot|
IRLIRLbot/|
Snapbot|Snap|
ichiro|ichiro|
shelob|shelob|
Google AdSense|Mediapartners-Google|
HatenaScreenshot|HatenaScreenshot|
Yahoo FeedSeeker|YahooFeedSeeker/|
Baiduspider|Baiduspider|
BlogPulse|BlogPulse|
Icerocket|BlogSearch|
BlogsNow|BlogsNowBot|
Feed::Find|Feed::Find|
Google Feedfetcher|Feedfetcher-Google|
Feedster|Feedster Crawler|
Gigablast|http://www.gigablast.com/spider.html|
LarBin|larbin_|
Megite|Megite2.0|
Micosi JP|micosi.jp|
Micro$oft Bot |MSRBOT|
